2 2 2 5 5 5 5 2 2 2 2 2 2 2 2 2 2 2 2 2 2 2 2 2 2 2 2 2 2 2 2 2 2 2 2 2 2 2 2 2 2 2 2 2 2 2 2 2 2 2 
2 3 3 5 5 5 5 3 3 3 3 2 1 3 0 0 0 0 0 0 0 0 0 0 0 0 0 0 7 7 7 7 7 7 7 7 7 7 7 10 10 10 4 4 4 4 4 4 4 2
2 3 3 5 5 5 5 3 11 12 3 2 1 3 0 0 0 5 5 5 5 5 5 0 0 0 0 0 1 1 1 9 7 7 7 7 7 7 7 10 10 10 4 4 4 4 4 4 4 2
2 3 3 5 5 5 5 0 13 14 3 2 0 3 0 0 5 5 5 5 6 5 5 5 5 5 5 5 1 1 1 1 1 1 1 0 0 0 1 10 10 10 10 10 10 4 4 4 4 2
2 3 0 5 5 5 5 0 0 0 3 2 3 3 0 0 5 5 5 5 5 5 5 5 5 5 5 5 5 5 5 5 5 5 5 5 1 1 0 1 10 6 10 10 10 10 4 4 4 2
2 0 0 5 5 5 5 3 0 0 1 1 0 3 0 5 5 5 5 0 0 0 0 0 0 0 0 0 0 0 0 0 10 5 10 5 1 1 1 0 10 10 10 10 10 10 10 10 10 2
2 0 0 5 5 5 5 3 3 0 0 1 2 3 5 5 5 5 0 0 0 0 0 0 0 0 0 0 0 0 0 0 0 0 10 5 10 10 10 10 10 10 0 0 0 0 0 0 0 2
2 5 5 5 5 5 5 5 5 5 5 5 5 5 5 5 5 0 0 0 0 2 2 2 2 2 2 0 0 0 0 0 0 0 5 10 10 10 10 10 10 10 0 0 0 0 0 0 0 2
2 5 5 5 5 5 5 5 5 5 5 5 5 5 5 5 0 0 0 0 2 2 5 5 5 5 2 0 0 0 0 0 0 0 0 0 0 0 10 10 10 10 0 0 0 0 0 0 0 2
2 3 3 3 3 0 0 1 0 0 3 4 4 0 0 0 0 0 0 2 3 5 5 5 5 5 2 0 0 0 0 0 0 0 0 0 0 0 0 5 5 0 0 0 0 0 0 0 0 2
2 3 3 3 0 0 0 1 1 1 1 4 4 0 0 0 0 0 2 3 3 3 5 5 5 5 2 0 0 0 0 0 0 0 0 0 0 0 0 5 5 0 0 0 0 0 0 0 0 2
2 3 3 3 0 0 0 1 1 1 1 1 1 0 0 0 0 2 2 3 3 3 5 5 5 5 2 0 0 0 0 0 0 0 0 0 0 0 0 5 5 0 0 0 0 0 0 0 0 2
2 2 2 2 2 5 2 2 2 2 2 1 2 2 2 2 2 2 0 0 3 3 5 5 5 5 2 0 0 0 0 0 0 0 0 0 0 0 0 5 5 0 0 0 0 0 0 0 0 2
2 3 3 5 5 5 5 3 3 3 3 2 3 1 1 1 0 0 0 0 0 5 5 5 5 5 2 0 0 0 0 0 0 0 0 0 0 0 0 5 5 0 0 0 0 0 0 0 0 2
2 3 3 5 5 5 5 3 3 3 3 2 0 4 0 0 0 0 0 0 5 5 5 0 0 0 2 0 0 0 0 0 0 0 0 0 0 0 0 5 5 5 0 0 0 0 0 0 0 2
2 2 2 5 5 4 4 1 0 0 3 0 1 1 0 0 0 0 0 0 5 5 5 0 0 0 2 0 0 0 0 0 0 0 0 0 0 0 5 5 5 5 5 0 0 0 0 0 0 2
2 0 0 5 5 0 0 0 0 0 0 0 0 0 0 0 0 0 0 5 5 5 0 0 0 0 2 0 0 0 0 0 0 0 0 0 0 5 5 5 0 5 5 5 0 0 0 0 0 2
2 0 0 10 10 0 0 0 0 0 0 0 0 0 0 0 0 0 5 5 5 0 0 0 0 2 0 0 0 0 0 0 0 0 0 5 5 5 5 0 0 0 5 5 5 0 0 0 0 2
2 0 0 10 10 0 0 0 0 0 0 0 0 0 0 0 0 0 5 5 5 0 0 0 2 0 0 0 0 0 0 0 0 0 5 5 5 5 0 0 0 0 0 5 5 5 0 0 0 2
2 0 0 10 10 10 0 0 0 0 0 0 0 0 0 0 0 5 5 5 0 0 0 2 0 0 0 0 0 0 0 0 5 5 5 5 0 0 0 0 0 0 0 0 5 5 5 0 0 2
2 0 0 0 10 10 10 10 10 10 10 10 10 5 5 5 5 5 5 5 0 0 2 0 0 0 0 0 0 0 0 0 0 0 0 0 0 0 0 0 0 0 0 0 0 5 5 5 0 2
2 0 0 0 0 10 10 10 10 10 10 10 10 5 5 5 5 5 5 5 0 2 0 0 0 0 0 0 0 0 0 0 0 0 0 0 0 0 0 0 0 0 0 0 0 5 5 5 0 2
2 4 4 4 4 4 4 4 4 1 1 5 5 1 4 4 4 4 4 4 4 4 3 3 0 0 0 0 0 0 0 0 0 0 0 0 0 0 0 0 0 0 0 0 0 5 5 5 0 2
2 4 4 4 4 4 4 4 4 4 1 5 5 1 1 4 4 4 4 4 4 4 4 3 3 0 0 0 0 0 0 0 0 0 0 0 0 0 0 0 0 0 0 0 0 5 5 5 0 2
2 4 4 8 8 4 4 4 4 4 1 5 5 5 1 1 4 4 4 4 4 4 4 4 3 0 0 0 0 0 0 0 0 0 0 0 0 0 0 0 0 0 0 0 0 5 5 5 0 2
2 4 4 8 8 4 4 4 4 4 1 1 5 5 1 1 4 4 8 8 4 4 4 4 3 0 0 0 0 0 0 0 0 0 0 0 0 0 0 3 0 0 0 0 0 5 5 5 0 2
2 4 4 4 4 4 4 4 4 4 4 1 5 5 1 4 4 4 8 8 4 4 3 3 3 0 0 0 0 0 0 0 0 0 0 0 0 0 0 3 0 0 4 4 1 5 5 5 0 2
2 4 4 4 4 4 4 4 4 4 4 1 5 5 1 4 4 4 4 4 4 4 4 3 0 0 0 0 0 0 0 0 0 0 0 0 0 0 3 0 0 4 4 4 1 5 5 5 0 2
2 4 4 4 4 4 4 4 4 4 4 1 5 5 1 4 4 4 4 4 4 4 4 3 0 0 0 0 0 0 0 0 0 0 0 0 0 0 0 0 0 4 4 4 1 5 5 5 0 2
2 0 0 0 0 0 0 0 0 0 0 5 5 5 5 0 0 0 0 0 0 0 0 0 0 0 0 0 0 0 0 0 0 0 0 0 0 0 3 0 0 0 4 4 1 5 5 5 0 2
2 0 0 0 0 0 0 0 0 0 0 5 5 5 5 0 0 0 0 0 0 0 0 0 0 0 0 0 0 0 0 0 0 0 0 0 0 0 0 3 0 0 0 0 1 5 5 0 0 2
2 0 0 0 0 0 0 0 0 0 0 5 5 5 5 0 0 0 0 0 0 0 0 0 0 0 0 0 0 0 0 0 0 0 0 0 0 0 0 3 3 0 0 1 5 5 5 0 0 2
2 0 0 0 0 0 0 0 0 5 5 5 5 5 5 5 0 0 0 0 0 0 0 0 0 0 0 0 0 0 0 0 0 0 0 0 0 0 3 0 0 0 0 0 5 5 5 0 0 2
2 0 0 0 0 0 5 5 5 5 5 5 5 5 5 5 5 5 5 0 0 0 0 0 0 0 0 0 0 0 0 0 0 0 0 0 3 3 0 0 0 0 0 5 5 5 0 0 0 2
2 0 0 0 0 5 5 5 5 5 5 5 5 5 5 5 5 5 5 5 0 0 0 0 0 0 0 0 0 0 0 0 0 0 0 0 3 0 0 0 0 0 0 5 5 5 0 0 0 2
2 0 0 0 5 5 5 5 5 3 3 3 3 3 1 1 5 5 5 5 5 0 0 0 0 0 0 0 0 0 0 0 0 0 0 0 0 0 0 0 0 0 0 10 5 5 0 0 0 2
2 0 0 5 5 5 5 3 3 3 3 3 3 1 1 1 1 3 5 5 5 5 0 0 0 0 0 0 0 0 3 3 3 3 3 3 3 3 3 3 3 3 3 5 10 5 3 3 3 2
2 0 0 5 5 5 3 3 3 3 3 3 1 1 1 3 3 3 3 5 5 5 0 0 0 0 0 0 0 0 3 3 3 3 3 3 3 3 3 3 3 3 3 10 6 10 3 3 3 2
2 0 0 5 5 5 3 3 3 3 3 1 1 1 3 3 3 3 3 5 5 5 0 0 0 0 0 0 0 3 3 3 3 3 3 3 3 9 3 3 3 3 10 10 10 3 3 3 3 2
2 0 0 5 5 5 3 3 3 3 1 1 1 3 3 3 3 3 3 5 5 5 0 0 0 0 0 0 3 3 3 3 3 9 3 3 3 3 3 3 3 10 10 10 3 3 3 3 3 2
2 0 0 5 5 5 3 3 3 1 1 1 3 3 3 3 3 3 3 5 5 5 0 0 0 0 0 0 3 3 3 3 3 3 3 3 3 3 3 3 3 10 10 10 3 3 3 3 3 2
2 0 0 5 5 5 3 3 1 1 1 3 3 3 3 3 3 3 3 5 5 5 0 0 0 0 0 0 0 3 3 3 3 3 3 3 3 3 3 3 3 3 10 10 10 3 3 3 3 2
2 0 0 0 5 5 5 5 5 1 3 3 3 3 3 3 5 5 5 5 5 0 0 0 0 0 0 0 0 0 3 3 3 3 3 9 3 3 3 3 3 3 3 10 10 10 3 3 3 2
2 0 0 0 0 5 5 5 5 5 5 5 5 5 5 5 5 5 5 5 0 0 0 0 0 0 0 0 0 0 0 3 3 3 3 3 3 3 3 3 3 3 3 3 5 5 10 3 3 2
2 0 0 0 0 0 5 5 5 5 5 5 5 5 5 5 5 5 5 0 0 0 0 0 0 0 0 0 0 0 5 0 3 3 3 3 3 3 3 3 3 3 3 3 3 5 10 10 3 2
2 0 0 0 0 0 0 0 0 5 5 5 5 5 5 5 0 0 0 0 0 0 0 0 0 0 0 0 0 0 5 5 5 5 5 5 5 3 3 3 5 5 5 3 3 10 10 3 3 3 
2 0 0 0 0 0 0 0 0 0 0 0 0 0 0 0 0 0 0 0 0 3 3 3 3 3 3 3 3 3 5 5 5 5 10 5 10 10 5 5 5 10 10 10 10 10 3 3 3 3
2 0 0 0 0 0 0 0 0 0 0 0 0 0 0 0 0 0 0 3 3 3 3 3 3 3 3 3 3 3 3 3 3 3 3 3 5 10 5 10 5 10 10 10 10 5 3 3 3 3
2 0 0 0 0 0 0 0 0 0 0 0 0 0 0 0 0 0 0 3 3 3 3 3 3 3 3 3 3 3 3 3 3 3 3 3 3 3 3 3 3 3 3 3 3 3 3 3 3 3
2 2 2 2 2 2 2 2 2 2 2 2 2 2 2 2 2 2 2 3 3 3 3 3 3 3 3 3 3 3 3 3 3 3 3 3 3 3 3 3 3 3 3 3 3 3 3 3 3 3